B B B B B B B B B B B B B B B B B B B B B B B _ _ _ _ _ _ _ _ _ _ _ _ _ _ B B B B B B B _ _ _ _ _ _ _ _ _ _ _ _ _ _ _ _ _ _ _ _ _ _ _ _ _ _ _ _ _ _ _ _ _ _ _ _ _ _ _ _ B _ _ _ _ _ _ _ _ _ _ _ _ _ _ _ _ _ _ _ _ _ _ _ B _ _ _ _ _ _ _ _ _ _ _ _ B
B B B B B B B B B B B B B B B B B B B B B B B _ _ _ _ _ _ _ _ _ _ _ _ _ _ P _ P _ P _ P _ _ _ _ _ _ _ _ _ _ _ _ _ _ _ _ _ _ _ _ _ _ _ _ _ _ _ _ _ _ _ _ _ _ _ _ _ _ _ _ _ _ _ _ _ _ _ _ B B _ _ _ _ _ _ _ _ _ _ _ _ _ B B _ _ _ _ _ _ _ _ _ _ _ _ B
B B B B B B B B B B B B B B B B B B B B B B B _ _ _ _ _ _ _ _ _ _ _ _ _ _ _ _ _ _ _ _ _ _ _ _ _ _ _ _ _ _ _ _ _ _ _ _ _ _ _ _ _ _ _ _ _ _ _ _ _ _ _ _ B B B B _ _ _ _ _ _ _ B B _ _ _ _ _ _ _ _ _ _ _ _ _ _ _ _ B B B B B _ _ _ _ _ _ _ t _ _ _ s B
B B B B B B B B B B B B B B B B B B B B B B B _ _ _ _ _ _ _ _ t _ _ _ _ _ _ _ _ _ _ _ _ _ _ _ _ _ _ _ _ _ _ _ _ _ _ _ _ _ _ _ _ _ _ _ _ _ _ _ _ _ _ _ B B B B B B _ _ _ _ _ _ _ B _ _ _ _ _ _ _ _ _ _ _ _ _ _ _ _ _ _ _ _ _ _ _ _ _ _ _ _ _ _ _ _ B
B B B B B B B B B B B B B B B B B B B B B B B _ _ s _ _ _ _ _ _ _ _ _ _ _ _ _ p _ _ _ _ _ _ _ _ _ _ _ _ _ _ _ _ _ _ _ _ _ _ b _ _ _ _ _ _ _ _ _ _ _ _ _ _ _ _ _ _ _ _ _ _ _ _ _ _ _ _ _ _ _ _ _ B B B B B B B _ _ _ _ _ _ _ B B B B B B B B B B B B
B B B B B B B B B B B B B B B B B B B B B B B B B B B B B _ _ _ _ _ _ _ _ _ _ _ _ _ _ _ _ _ _ _ _ _ _ _ _ _ _ _ _ _ _ _ _ _ _ _ _ _ S _ _ _ _ _ _ _ _ _ _ _ _ _ _ _ _ B B B B B B _ _ S B _ _ _ _ _ _ _ _ _ _ _ _ _ _ _ _ _ _ _ _ _ _ _ _ _ _ _ _ B
B B B B B B B B B B B B B B B B B B B B B B B B B B B B B B B B B B B B B B B B B B B B L L L L L L L L L L B B B B B B B B B B B B B B B B B B B B B B B B B _ _ _ _ _ B B B B B B B B B B B B B B B L L _ _ _ L L B B B B B L _ _ L B B B B B B B
B B B B B B B B B B B B B B B B B B B B B B B B B B B B B B B B B B B B B B B B B B B B B B B B B B B B B B B B B B B B B B B B B B B B B B B _ _ _ _ _ _ _ _ g _ _ _ B _ _ _ _ _ _ _ _ _ _ _ _ B B B B B B B B B B B B B B B L _ _ L B B B B B B B
B B B B B B B B B B B B B B B B B B B B B B B B B B B B B B B B B B B B B B B B B B B B B B B B B B B B B B B B B B B B B B B B B B B B B B B _ _ B B B B B B B B B B B B B B B B B B B B B B B B B B B B B B B B B B B B B B B L L B B B B B B B B
B _ _ _ _ _ _ _ _ _ L L L L L L L L _ _ _ _ _ _ _ _ _ _ _ _ _ _ _ _ _ _ _ _ _ _ _ _ _ _ _ _ _ _ _ _ _ _ _ _ _ _ _ _ _ _ _ _ _ _ _ _ _ _ _ _ B B _ _ _ _ _ _ _ _ _ _ B B _ _ _ _ _ _ _ _ _ _ _ _ _ _ _ b _ _ _ _ _ _ _ _ _ b _ _ _ _ _ _ _ _ _ _ _ B
B _ _ _ _ _ _ _ _ _ L _ _ _ _ _ _ L _ _ _ _ _ _ _ _ _ _ _ _ _ _ _ _ _ _ _ _ _ _ _ _ _ _ _ _ _ _ _ _ _ _ _ _ _ _ _ _ _ _ _ _ _ _ _ _ _ _ _ _ B B B _ _ _ _ _ _ _ _ _ B B _ _ _ _ _ _ _ _ _ _ _ _ _ _ _ _ _ _ _ _ _ _ _ _ _ _ _ _ _ _ _ _ _ _ _ _ _ B
B _ _ _ _ _ _ _ _ _ _ _ _ _ _ _ _ _ _ _ _ _ _ _ _ _ _ _ _ _ _ _ _ _ _ _ _ _ _ _ _ _ _ _ _ _ _ _ _ _ _ _ _ _ _ _ _ _ _ _ _ _ _ _ _ _ _ _ _ _ _ _ _ B _ _ _ _ _ _ B B B B _ _ _ _ _ _ _ _ _ _ _ _ _ _ _ _ _ _ _ _ b _ _ _ _ _ _ _ _ _ _ _ _ _ _ _ _ B
B _ _ _ _ _ _ _ _ _ _ _ _ _ t _ _ _ _ _ _ _ _ _ _ _ _ _ _ _ _ _ _ _ _ _ _ _ _ _ _ _ S _ _ _ _ _ _ _ _ _ _ _ _ _ _ _ _ _ _ _ _ _ _ _ t _ _ _ _ _ _ _ _ _ _ _ B B B B B B _ _ _ _ _ _ _ _ _ _ _ b _ _ _ _ _ _ _ _ _ _ _ _ _ _ _ _ _ _ _ _ _ _ _ _ _ B
B _ _ _ _ _ _ _ _ _ _ _ _ _ _ _ _ _ _ _ _ _ _ _ _ _ _ _ _ _ _ _ _ _ _ _ _ _ _ S _ _ _ _ _ _ s _ _ _ _ _ _ _ _ _ _ _ _ _ _ _ _ _ _ _ _ _ _ _ _ _ _ _ B B B B B B B B B B _ _ t _ _ _ _ _ _ _ _ _ _ _ t _ _ _ _ _ _ _ _ t _ _ _ _ _ _ b _ _ t _ _ _ B
B _ y2 _ _ _ _ _ _ _ _ _ _ _ _ _ _ _ _ b _ _ _ _ _ _ _ _ _ _ _ _ _ _ _ _ _ _ _ _ _ _ _ _ _ S _ _ _ p _ _ _ _ _ _ _ _ _ _ _ _ _ _ _ _ C _ _ _ _ _ _ _ B B B _ _ _ _ _ _ _ _ _ _ _ _ _ _ b _ _ _ _ _ _ _ _ b _ _ _ _ _ _ _ _ _ _ _ _ _ _ _ _ _ _ _ _ B
B B B B B B B B B B B B B B B B B B B B B B B B B B B B B B B B B B B B B B L L L L L L L L B B B B B B B B B B B B B B B B B B B B B B B B B B B B B B B B B B B B B B B B B B B B B B B B B B B B B B B B B B B B B B B B B B B B B B B B B B B B
