I I I I I I I I I I I I I I I I I I I I I I I I I I I I I I I
I _ _ _ _ _ _ _ _ _ _ _ _ _ _ _ _ _ _ _ _ _ _ _ _ _ _ _ _ _ I
I _ _ _ _ _ _ _ _ _ _ _ _ _ _ _ _ t _ _ _ _ _ _ _ _ _ _ _ _ I
I y2 _ _ _ _ _ _ _ _ _ _ _ _ _ _ _ _ _ _ _ _ _ _ _ _ _ _ _ _ I
I _ _ _ _ _ _ _ _ _ _ _ _ _ _ _ _ _ _ _ _ _ _ _ _ _ _ _ _ _ I
I _ _ _ _ _ _ _ _ _ _ _ _ _ _ _ _ _ _ _ _ _ _ _ _ _ _ _ _ _ I
I I I I I I I I I I _ _ _ _ _ I I I I I I I I I _ _ _ I I I I
I _ _ _ _ _ _ _ _ _ _ _ _ _ _ _ _ _ _ _ _ _ _ _ _ _ _ I I I I
I _ _ _ _ _ _ _ _ _ _ _ _ _ _ _ _ _ _ _ _ _ _ _ _ _ I I I I I
I _ _ _ _ _ _ _  _ _ _ _ _ _ _ _ _ _ _ _ _ _ _ _ _ _ _ _ _ I
I I I I I I I I I I I I I I I I I I I I I I I _ _ _ _ I I I I
I _ _ _ _ _ _ _ _ _ _ _ _ _ _ _ _ _ _ _ _ _ _ _ _ _ _ _ _ _ I
I _ _ _ _ _ _ _ _ _ _ _ _ _ p _ _ _ _ _ _ _ _ _ _ _ _ _ _ _ I
I _ _ _ _ _ _ _ _ _ _ _ _ I I I I I _ _ _ _ _ _ _ _ _ _ _ _ I
I I I I I I _ _ _ _ I I I I _ _ _ I I I I I I I I I I I I I I
I _ _ _ _ _ _ _ _ _ _ _ _ _ _ _ _ _ _ _ _ _ _ _ _ _ _ _ _ _ I
I _ _ _ _ _ _ _ _ _ _ _ _ _ _ _ _ _ _ _ _ _ s _ _ _ _ _ _ _ I
I _ _ _ _ _ _ _ _ _ _ _ _ _ _ _ _ I I I I I I I I I _ _ _ _ I
I _ _ _ _ _ _ _ _ _ _ _ _ _ _ _ _ _ _ _ _ _ _ _ _ _ _ _ _ _ I
I _ _ _ _ _ _ _ _ _ _ _ _ _ _ _ _ _ _ _ _ _ _ _ _ _ _ _ _ _ I
I _ _ _ _ _ _ _ _ _ _ S _ _ _ _ _ _ _ _ _ _ _ _ _ _ _ _ _ _ I
I _ _ _ _ _ I I I I _ _ _ _ _ _ _ _ _ _ _ t _ _ _ _ _ _ _ _ I
I _ _ _ _ I I I I I _ _ _ _ _ _ _ _ _ _ _ _ _ _ _ _ _ _ _ _ I
I _ _ _ _ _ _ _ _ _ _ _ _ _ _ _ _ _ _ _ _ _ _ _ _ _ _ _ _ _ I
I I I I I I I I I I I I I I I I _ _ _ _ _ _ _ _ _ _ _ _ _ _ I
I _ _ _ _ _ _ _ _ _ _ _ _ _ _ _ _ _ _ _ _ _ _ _ _ _ _ _ _ _ I
I _ _ _ _ _ _ _ _ _ _ _ _ _ _ _ _ I I I I I I I I I I I I I I
I _ _ _ _ _ _ _ _ _ _ _ _ _ _ _ _ I _ _ _ _ _ _ _ _ _ _ _ _ I
I _ _ I _ _ _ _ _ _ _ k _ _ _ _ _ I _ _ _ _ _ _ _ _ _ _ _ _ I
I _ _ I I I I I I I I I I I I I I I_ _ _ _ _ _ _ _ _ _ _  _ I
I _ _ _ _ _ _ _ _ _ _ _ _ _ _ _ _ _ _ _ _ _ _ _ _ _ _ _ _ _ I
I _ _ _ _ _ _ I I I I I I I I I _ _ _ _ _ _ _ _ _ _ _ _ _ _ I
I _ _ _ _ _ _ I I _ _ _ _ _ _ _ I _ _ _ _ _ _ _ _ _ _ _ _ _ I
I _ _ _ _ _ _ I I _ _ _ _ _ _ _ I I I _ _ _ _ _ _ _ _ _ _ _ I
I _ _ _ _ _ S I I s _ _ _ _ _ _ _ I I I I _ _ _ _ _ _ _ _ _ I
I _ _ _ _ _ _ I I I I _ _ _ _ _ _ _ I I I I I _ p _ _ _ _ _ I
I I I I I I I I I _ _ _ _ S _ _ _ _ _ I I I I I I _ _ _ _ _ I
I _ _ _ _ _ _ _ _ _ _ _ _ _ _ _ _ _ _ _ _ _ _ _ _ _ _ _ _ _ I
I _ _ _ _ _ _ _ _ t _ _ _ _ _ S _ _ _ _ _ _ _ _ _ _ _ _ _ _ I
I _ _ _ _ _ _ _ _ _ _ _ _ _ _ _ _ _ _ _ S _ _ _ _ I I I I I I
I _ _ _ _ _ g _ _ _ _ _ _ _ _ _ _ _ _ _ _ _ _ _ _ _ _ _ _ _ I
I I I I I I I I I I I I I I I _ _ _ _ _ _ _ _ _ _ _ _ _ _ _ I
I _ _ _ _ _ _ _ _ _ _ _ _ _ _ _ _ _ _ _ _ _ _ _ _ _ _ _ _ _ I
I _ _ _ _ _ _ _ _ _ _ _ _ _ _ _ _ _ _ _ _ _ _ _ _ _ _ _ _ _ I
I _ _ _ _ _ _ _ _ _ _ _ _ _ _ _ _ _ _ _ _ _ _ _ _ _ _ _ _ _ I
I _ _ _ _ _ _ _ _ _ g _ _ _ I _ _ _ _ _ _ _ _ _ _ _ _ _ _ _ I
I I I _ _ I I I I I I I I I I _ _ _ _ _ _ _ _ _ _ _ _ _ _ _ I
I _ _ _ _ _ _ _ _ _ _ _ _ _ I _ _ _ _ S _ _ _ _ _ _ _ _ _ _ I
I _ _ _ _ _ _ _ _ _ _ _ _ _ _ I I _ _ _ _ _ I I I I I _ _ _ I
I I I I _ _ _ _ _ _ _ _ _ _ _ _ I _ _ _ _ _ _ _ _ _ I _ _ _ I
I _ I I I I _ _ _ _ _ _ _ t _ _ I _ _ _ _ _ _ _ _ _ I _ _ _ I
I _ _ _ I I I I _ _ _ _ _ _ _ _ I _ _ _ _ _ _ _ k _ I _ _ _ I
I _ _ _ _ _ _ _ _ _ _ _ _ _ _ _ I I I I I I I I I I I I I I I
I _ _ _ _ _ _ _ _ _ _ _ _ _ _ _ _ I _ _ _ _ _ _ _ _ _ _ _ _ I
I _ _ _ _ _ _ _ I I I I I I I I I I _ _ _ _ _ _ _ _ _ _ _ _ I
I_ _ _ _ _ _ _ _ _ _ _ _ _ _ _ _ _ _ _ _ _ _ _ _ _ _ _ _ _  I
I _ _ _ _ _ _ _ _ _ _ _ _ _ _ _ _ _ _ _ _ _ _ _ _ _ _ _ _ _ I
I _ _ _ _ _ _ _ _ _ _ _ _ _ _ _ _ _ _ _ _ _ _ _ _ _ _ _ _ _ I
I _ _ _ _ _ _ _ _ _ _ _ _ _ _ _ _ I _ _ _ _ _ _ _ _ _ _ _ _ I
I _ _ _ _ _ _ _ _ _ _ _ _ _ _ _ _ I _ _ _ _ _ _ _ _ _ _ _ _ I
I _ _ _ _ _ _ _ _ _ _ _ _ p I I I I I I I I _ _ _ I I I I I I
I _ _ _ _ _ _ _ _ _ _ _ I I _ _ _ _ _ _ _ _ _ _ _ _ _ _ _ _ I
I _ _ _ _ g _ _ _ _ _ I _ _ _ _ _ _ _ _ _ _ _ _ _ _ _ _ _ _ I
I I I I I I I I I I I I _ _ _ _ _ _ _ t _ _ _ _ _ _ _ _ _ _ I
I _ _ _ _ _ _ _ _ _ _ _ _ _ _ _ _ _ _ _ _ _ _ _ _ _ _ _ _ _ I
I _ _ _ _ _ _ _ _ _ _ _ _ _ _ _ _ _ _ _ _ _ _ _ _ _ _ _ _ _ I
I _ _ _ _ _ _ B B B _ B _ B _ B B _ _ B _ B _ _ _ B _ B B _ I
I _ s _ _ _ _ B _ B _ B B _ _ B _ B _ B _ B B B _ B _ _ B _ I
B B B B B B B B B B B B B B B B B B B B B B B B B B B B B B B
